111111111111111111111111111111111
10000000000000000010000000000C011
10000000C00000000000000000P000011
111111111111111111100000000000011
100000000000000000100000000000011
111111111111110000100000000000011
100000000000010010111111111011111
100000C00001010010000000000000011
10000000000101001C000000000000011
10E000000001000010000000000000011
111111111111111111111111111111111