111111111111111111111111111111111
1000M000000000000010M00000000C011
10000000C00000000000000000P000011
111111111111111111100000000000011
100000000000000000100000M00000011
111111111111110000100000000000011
100000000000010010111111111011111
100000C00001010010000000000000011
1M000000000101001C0M000000M000011
10E000000001000010000000000000011
111111111111111111111111111111111