11111111111111
1ECP0000000M01
10000000000M01
10000000000001
11111111000M01
1000000C000M01
10000000000001
10CM0000000MC1
11111111111111