11111111111111
1ECP0000000M01
11111111111111