1111111111111
1C000000000C1
1000000000001
100000000M001
100M000000001
100000E000001
1000000P00001
1000000000001
1000000000001
1C000000000C1
1111111111111