1111111111111111111111111
1111111110000000000000111
1111111100001100010000111
1111111000011100110M00111
1111110M001111P1110000111
1111100001111111100001111
1111000011111111000011111
1110M001111111100M0111111
1100000000M0010000111E111
1100000000000100001100111
111111111100010M001000111
1111111111000100000000111
11111111110M0111111111111
1111111111C00111111111111
1111111111111111111111111