1111111111111111111111111
1111111110000000000000111
1111111100001100010000111
1111111000011100110000111
11111100001111P1110000111
1111100001111111100001111
1111000011111111000011111
1110000111111110000111111
110000000000010000111E111
1100000000000100001100111
1111111111000100001000111
1111111111000100000000111
1111111111000111111111111
1111111111C00111111111111
1111111111111111111111111